10 10
W W M W W W O O O W
 W O O O W O O O O W
W O W O O W W O O W
 W O W O W W O O W W
W O W O O O O W O W
 W O W O W W O W O W
W O W O W W W O W W
 W O W O O W C O W W
W O O W O O O W O W
 W O O O W O O O O W